##########
#    X   #
#        #
###%%#####
#b    C  #
#  C     #
#       X#
#   ######
#E t#t m #
##########