OOOOOOOOOO
O#########
O#XXgX tm#
O#g#%%   #
O#C  #####
O#  C    #
O# C   t #
O#  E    #
O#########
OOOOOOOOOO