##########
#        #
#   X    #
# t      #
#        #
########%#
#m       #
#        #
#E   C  t#
##########