##########
#b  X   X#
#       g#
#   C   g#
# tm     #
#     S# #
#  C   #C#
# t%s O# #
#  X   #E#
##########