##########
##########
##########
##########
##E     ##
##  C  X##
##########
##########
##########
##########