OOOOOOOOOO
OOOOOOOOOO
##########
#   gX X #
#      #g#
#E   C C #
######   #
OOOOO#####
OOOOOOOOOO
OOOOOOOOOO